11,11
11,9,5,5,5,5,5,3,9,5,3
10,10,9,1,5,5,7,12,2,9,6
10,12,2,14,9,3,9,3,14,8,3
12,3,14,9,6,10,10,12,3,14,10
11,12,5,6,11,10,12,3,12,3,10
8,5,5,1,6,12,5,6,9,6,10
8,3,13,2,9,1,5,3,12,5,2
10,12,3,14,10,12,3,12,5,3,10
12,7,12,3,10,11,12,5,3,10,10
9,5,5,6,10,12,3,9,6,14,10
12,5,5,5,4,5,6,12,5,5,6
