9,9
0,0,8,8
13,5,3,1,1,1,1,1,3
8,0,10,0,0,0,0,0,2
8,0,12,5,3,0,0,0,2
8,0,0,0,10,0,0,0,2
8,0,0,0,12,5,3,0,2
8,0,0,0,0,0,10,0,2
8,0,0,0,0,0,12,5,3
8,0,0,0,0,0,0,0,10
12,4,4,4,4,4,4,4,14

