8,6
0,0,1,5
13,5,5,3,1,13,3,3
8,0,0,10,0,0,10,2
8,0,0,8,5,5,2,2
8,0,0,10,0,0,10,2
8,0,0,10,0,13,6,2
12,13,5,6,4,4,4,6